██████████████████████████████████████████████████████████  ██████████
██                  ██  ██                          ██              ██
██████  ██████████████  ██████████████████████  ██████  ██████  ██  ██
██              ██  ██      ██          ██          ██  ██      ██  ██
██████████  ██████  ██  ██  ██  ██  ██████████  ██████████  ██████████
██          ██  ██  ██  ██      ██  ██  ██  ██      ██  ██  ██  ██  ██
██  ██████  ██  ██  ██████  ██  ██  ██  ██  ██  ██████  ██  ██  ██  ██
██  ██          ██  ██  ██  ██  ██  ██          ██  ██  ██          ██
██████████████  ██  ██  ██  ██████████  ██  ██████  ██  ██  ██████  ██
██          ██                  ██      ██      ██          ██      ██
██  ██████████████████  ██████████  ██████  ██████  ██████  ██████  ██
██  ██      ██  ██      ██          ██  ██          ██  ██  ██        
██  ██████  ██  ██████  ██  ██████████  ██  ██████  ██  ██████████  ██
██  ██          ██          ██  ██      ██  ██  ██  ██      ██      ██
██  ██████  ██  ██████  ██  ██  ██████  ██████  ██  ██  ██  ██████  ██
██  ██      ██  ██      ██                      ██  ██  ██          ██
██  ██████████  ██████  ██  ██  ██████  ██████  ██████  ██████████  ██
██          ██      ██  ██  ██      ██  ██          ██  ██          ██
██████  ██████████  ██  ██  ██████████████  ██████████████████  ██████
██  ██              ██  ██          ██      ██          ██          ██
██  ██  ██  ██████  ██  ██████  ██████████████████████  ██████  ██████
██  ██  ██  ██          ██              ██  ██                      ██
██  ██████████████████████████████  ██████  ██████  ██  ██████████  ██
██  ██  ██                                  ██  ██  ██      ██  ██  ██
██  ██  ██  ██████  ██████████████  ██  ██  ██  ██  ██  ██████  ██  ██
██          ██  ██  ██              ██  ██  ██      ██  ██  ██  ██  ██
██████████████  ██  ██  ██████  ██  ██████████████████  ██  ██  ██████
██  ██              ██      ██  ██      ██              ██          ██
██  ██████████  ██  ██████████  ██  ██████  ██████  ██████████  ██████
██      ██  ██  ██  ██      ██  ██      ██  ██                  ██  ██
██  ██  ██  ██  ██████████  ██  ██████  ██████  ██████████  ██  ██  ██
██  ██          ██      ██      ██  ██  ██  ██      ██      ██  ██  ██
██████  ██  ██████████  ██████  ██  ██████  ██████████  ██  ██████  ██
██      ██                  ██                      ██  ██          ██
██████████████████████████████████████████████████████████████████████

